А
Аванс — средства, выдаваемые заранее в счет покрытия предстоящих расходов или платежей

Аккредитив — поручение банка покупателя банку поставщика осуществить оплату продукции, отгруженной в адрес покупателя

Аккредитивная форма расчетов — форма безналичных иногородних расчетов за продукцию (услуги) посредством аккредитивов

Актив баланса — часть бухгалтерского баланса, характеризующая на отчетную дату в денежном выражении активы организации, их состав и размещение

Активы — экономические ресурсы хозяйствующего субъекта, выраженные в стоимостной оценке и способные приносить доход в будущем

Акциз — косвенный налог на товары массового потребления. Включается в цену товара

Аналитические счета — счета, детализирующие информацию, содержащуюся в обобщенном виде в синтетических счетах

Аналитический учет — система сбора и группировки учетной информации для целей управления организацией и составления бухгалтерской отчетности

Аудит — независимая проверка деятельности отдельно взятой организации с целью изучения достоверности финансовой отчётности компании

Б
Бухгалтерская запись (проводка) — наименование дебетуемого и кредитуемого счетов с указанием суммы по ним

Бухгалтерская отчетность — система показателей, отражающих имущественное и финансовое положение организации на отчетную дату, а также финансовые результаты ее деятельности за отчетный период

Бухгалтерский баланс — это способ группировки имущества организации как по составу и размещению, так и по источникам образования и назначению в денежной оценке на определенную дату

Бухгалтерский учет — это упорядоченная система сбора, регистрации и обобщения информации в стоимостном выражении об активах организации и источниках их образования

Бюджет — форма организации фонда денежных средств

Бюджетно-распределительные счета — счета для распределения расходов по смежным отчетным периодам

В
Валовая продукция — показатель объема производства организации в денежном выражении

Валовой внутренний продукт (товар) — макроэкономический показатель, выражающий стоимость всех конечных продуктов (товаров и услуг), произведенных в стране в течение определенного периода

Валовый городской продукт — это индикатор рыночной стоимости товаров и услуг, произведенных во всех секторах экономики в городе за год

Валюта — а) денежная единица, лежащая в основе денежной системы страны; б) иностранные деньги, используемые в системе международных расчетов

Валюта иностранная — денежные знаки иностранных государств, кредитные средства обращения и платежа, используемые в международных расчетах

Валюта конвертируемая — денежные единицы, свободно обмениваемые на национальные валюты и международные платежные средства

Валюта неконвертируемая — денежная единица, функционирующая в пределах одной страны

Валютное регулирование — государственное регламентирование порядка осуществления расчетов с иностранными партнерами, операций с валютой и золотом

Валютный контроль — регулирование размера наличности в иностранной валюте, ее обменного курса на другие валюты

Векселедержатель — лицо, получившее вексель от векселедателя

Вексель — вид ценной бумаги, представляет собой письменное долговое обязательство, составленное в соответствии с законом в форме, дающее право его владельцу требовать по наступлении срока с векселедателя или акцептанта(ов) уплаты оговоренной денежной суммы

Вексель переводной (тратта) — выписывает векселедатель. Является приказом дебитору уплатить указанную в векселе сумму третьему лицу или его представителю

Вексель простой — письменное обязательство векселедателя заплатить сумму денег по наступлении срока платежа

Внеоборотные активы — часть активов организации, срок полезного использования которых свыше 12 месяцев, или обычного операционного цикла, превышающего 12 месяцев (основные средства,нематериальные активы, незавершенное строительство и др.)

Внутренняя отчетность — отчетность, применяемая организацией для нужд управления финансовой, производственной и технологической деятельностью

Восстановительная стоимость основных средств — применяется для оценки объектов основных средств с учетом изменения цен, тарифов и расценок

Г
Готовая продукция — составная часть материально-производственных запасов организации, предназначенная для продажи и соответствующая установленным техническим параметрам и другим стандартам

Д
Двойная запись — отражение каждой хозяйственной операции в одинаковой сумме по дебету и кредиту взаимосвязанных счетов

Двойное налогообложение — одновременное обложение в разных странах одинаковыми налогами доходов. Вызвано тем, что налоговый нерезидент должен платить налоги от общемировой прибыли одновременно и по месту своего фактического нахождения и по месту своего гражданства

Дебиторская задолженность — см. «Средства в расчетах»

Дебиторы — юридические и физические лица — должники организации

Декларация налоговая — заявление юридического (физического) лица, являющегося плательщиком налога, о размерах дохода, имущества и т. п

Декларация таможенная — заявление, направляемое в таможню при транспортировке товаров и других ценностей, направляемых через границу

Денежные документы — почтовые марки, оплаченные авиабилеты, путевки в санатории и дома отдыха, марки государственной пошлины, вексельные марки, находящиеся в кассе организации

Денежные средства — часть оборотных активов, используемых хозяйствующим субъектом для осуществления расчетов

Денежный эквивалент — это высоколиквидные финансовые вложения, которые могут быть легко обращены в заранее известную сумму денежных средств, подверженные незначительному риску изменения стоимости (п. 5 ПБУ 23/2011)

Депозит — сумма денег, переданная лицом кредитному учреждению с целью получить доход в виде процентов, образующихся в ходе финансовых операций с вкладом

Депозитный сертификат — ценная бумага, выдаваемая вносителю денег и удостоверяющая его право на их возврат в оговоренный срок вместе с процентами

Дивиденд — доход, получаемый владельцем акций. Является частью прибыли акционерного общества

Добавочный капитал — часть собственного капитала, созданного в результате дополнительного внесения средств сверх уставного капитала, изменения стоимости активов или их безвозмездного получения

Документация — письменное разрешение на проведение операции и подтверждение ее совершения

Документооборот — этапы движения документов от создания до передачи в архив

Документы (первичные, сводные) — первичные документы предназначены для оформления хозяйственных операций. Сводные документы обобщают информацию однородных первичных документов

Долгосрочные активы — часть экономических ресурсов, используемых в течение длительного времени

Долгосрочные обязательства — задолженность, срок погашения которой превышает 12 месяцев

Долгосрочные финансовые вложения — вложения денежных средств или иного имущества в другие организации на срок более одного года для получения дохода или контроля за их деятельностью

Долевые финансовые вложения — вклады в уставные капиталы других организаций

Дополнительная запись (проводка) — способ исправления ошибок в корреспонденции счетов, повторенных в разных учетных регистрах

Дополнительные счета — счета, увеличивающие оценку объектов, отраженную на основных счетах

Допущения — базовые принципы бухгалтерского учета

Доход по стоимости объекта строительства — способ определения финансового результата у подрядчика при полном завершении работ по договору. Доход рассчитывается как разница между договорной стоимостью законченного объекта и затратами по его возведению

Доход по стоимости работ по мере их готовности — способ определения финансового результата у подрядчика. Выявляется за определенный отчетный период после завершения работ по конструктивным элементам или этапам, предусмотренным проектом. Рассчитывается как разница между объемом выполненных работ и суммой приходящихся на них затрат

Доходы будущих периодов — доходы, полученные в одном отчетном периоде, но относящиеся к следующим отчетным периодам

Е
Единый налог на вмененный доход — система налогообложения для отдельных видов деятельности. Ключевое отличие, состоит в том, что налог учитывается, исходя не из фактического, а из вменённого (то есть предполагаемого) дохода. Не является обособленным режимом, и может применяться совместно с ОСНО или УСНО

З
Забалансовые счета — счета для учета имущества, не принадлежащего данной организации

Заем — взятые в долг деньги или имущество у других организаций (кроме банков) с обязательством их возврата

Заёмщик — сторона по кредитным отношениям, получающая кредит и принимающая на себя обязательство возвратить в установленный срок ссуженную стоимость и уплатить процент за время пользования ссудой

Залог — имущественное обеспечение основными средствами, товарно-материальными ценностями, ценными бумагами выполнения обязательств должника (торговой организации)

Затраты внепроизводственные — расходы по продаже продукции. Учитываются на счете 44 «Расходы на продажу»

Затраты на оплату труда — вид затрат, включаемый в издержки производства и обращения

Затраты на производство — расходы организации, связанные с производством продукции, работ и услуг

И
Импорт — а) ввоз в страну из-за границы товаров; б) приток в страну из-за границы капитала

Импортер — юридическое или физическое лицо, занимающееся ввозом товаров

Инвентаризация — проверка фактического наличия имущества в натуре

Инвестиция — долгосрочное вложение средств в организацию с целью получения дохода или ее расширения

Инвестор — лицо, организация или государство, осуществляющие инвестиции

Индоссамент — передаточная запись на векселе

К
Калькуляционные счета — счета для учета затрат и исчисления себестоимости продукции, работ и услуг

Калькуляция — расчет себестоимости единицы продукции, работ, услуг

Камеральная проверка — проверка, проводимая налоговым органом исключительно на основании данных, указанных в налоговых декларациях, без проведения каких-либо других видов проверок плательщика налогов

Капитал — стоимость вложенных собственниками активов и прибыль, накопленная за время функционирования организации

Капитальные вложения — затраты по строительству или приобретению объектов основных средств и нематериальных активов

Карточка подписи — карточка с оттиском печати и образцами подписей всех лиц, наделенных правом от имени организации распоряжаться деньгами на счету

Кассовый метод — метод учета доходов и расходов, при котором доходы признаются в день поступления средств на счета в банках или в кассу или нового имущества. Расходами признаются затраты после их фактической оплаты

Кассовый ордер — документ, оформляющий операции по поступлению и выдаче наличных денег из кассы

Комиссионный сбор — сбор, взимаемый за посреднические услуги

Комитент — лицо, дающее поручение другому лицу заключать сделку (сделки) от имени последнего, но за счет комитента

Коммерческие расходы — затраты, связанные с продажей продукции

Конвертация — это преобразование ценных бумаг одного типа или категории в ценные бумаги другого типа или категории

Коносамент — документ, выдаваемый перевозчикам грузов. Удостоверяет принятие груза к перевозке с обязательством доставки его в порт назначения и передачи законному владельцу

Консигнант — владелец товара, продаваемого за границу через посредника

Консигнатор — посредник, получающий от экспортера товар с целью его продажи за вознаграждение

Консигнация — вид комиссионной продажи товаров. Владелец передает консигнатору товар для продажи со склада комиссионера

Контрагент — противоположная сторона, участвующая в сделке. Другими словами, при создании сделки или договора участники являются друг для друга контрагентами

Косвенные затраты — затраты, относящиеся к двум и более видам выпускаемой продукции (работ, услуг). В себестоимость каждого вида изделия включаются путем распределения

Котировка — а) фиксирование цен на товарных биржах в течение рабочего дня; б) регистрация курса иностранной валюты или ценных бумаг

Краткосрочные обязательства — это задолженность, срок погашения которой не превышает одного года

Краткосрочные финансовые вложения — вложения денежных средств или иного имущества в другие предприятия на срок менее одного года для получения дохода или контроля за их деятельностью

Кредит — предоставление в долг товаров или денег

Кредит банковский — денежные ссуды и платежные средства, выданные банками и другими кредитно-финансовыми организациями при уплате долгов

Кредит коммерческий — предоставляется одной организацией другой в виде продажи товаров с отсрочкой платежа

Кредитный портфель — это совокупность остатков задолженности по основному долгу по активным кредитным операциям на определенную дату

Кредитор — физическое или юридическое лицо, в пользу которого организация должна осуществлять платеж либо выполнить определенные действия

Кредиторская задолженность — обязательства организации перед кредиторами за товары, работы, услуги и по прочим операциям, т. е. долги данного предприятия другим организациям и отдельным лицам

Л
Лизинг — долгосрочная аренда основных средств

Ликвидационная стоимость основных средств — состоит из двух слагаемых: а) стоимость материальных ценностей, оставшихся после ликвидации основных средств; б) стоимость работ по демонтажу объектов

Ликвидационный баланс — баланс, который составляется после принятия решения о ликвидации и после удовлетворения требований кредиторов (ст. 63 ГК РФ)

Лимит кассы — сумма наличных денежных средств в кассе предприятия, размер которых устанавливается банком в зависимости от конкретных условий функционирования организации

ЛИФО — способ оценки материалов при отпуске в производство: последняя партия к поступлению, первая в расход

М
Материально-производственные запасы — часть имущества, используемая при производстве продукции (работ, услуг), а также предназначенная для продажи и для управленческих нужд организации

Материальные активы — стоимость движимого и недвижимого имущества, которая в течение долгого времени принимает участие в хозяйственной деятельности и амортизируется

Метод начисления — способ учета доходов и расходов, при котором доходы признаются в том отчетном периоде, в котором имели место, независимо от фактического поступления денежных средств или иного имущества. Расходы признаются в том отчетном периоде, в котором возникли исходя из условий сделки

Методический аспект учетной политики — выбор альтернативных вариантов ведения учета

Н
Наличные расчеты — форма денежных расчетов. Широко используется в обслуживании денежных доходов и расходов населения

Налог — обязательный платеж, взимаемый государством в различных формах с физических и юридических лиц в государственный и местный бюджеты

Налог на добавленную стоимость — форма изъятия в бюджет части прироста стоимости созданной в процессе производства товаров, работ, услуг

Налог на доходы физических лиц — основной вид прямых налогов. Исчисляется в процентах от совокупного дохода физических лиц за вычетом документально подтверждённых расходов, в соответствии с действующим законодательством

Налоговая база — стоимостная, физическая или иная характеристика объекта налогообложения

Налоговая отчетность — это совокупность документов (расчеты и налоговые декларации), периодически представляемых налогоплательщиком по установленным формам в налоговые органы в обязательном порядке на основании требований действующего законодательства и содержащих информацию о состоянии обязательств юридического лица или индивидуального предпринимателя перед государством по исчислению и уплате налогов, взносов и сборов

Налоговое планирование — целенаправленные действия налогоплательщика, направленные на уменьшение его расходов на уплату налогов, сборов, пошлин и других обязательных платежей не нарушая законодательства

Налоговый учет — система обобщения информации для определения налоговой базы по налогу на основе данных первичных документов, сгруппированных в соответствии с порядком, предусмотренным НК РФ

Налогообложение — система изъятия денежных средств властным субъектом (государственными или муниципальными органами) у подчиненного объекта

Налогоплательщик — физическое или юридическое лицо, на которое законом возложена обязанность уплачивать соответствующие налоги

Незавершенное производство — предметы труда, находящиеся в обработке на рабочих местах

Нематериальные активы — средства хозяйства, не обладающие материальными или физическими свойствами, обеспечивающие возможность получения дохода постоянно или в течение длительного времени

Непокрытый убыток — финансовый результат, характеризующий уменьшение капитала организации за отчетный год

Нераспределенная прибыль — финансовый результат, характеризующий увеличение капитала организации за отчетный год и весь период ее деятельности

Нерезидент — юридическое/физическое лицо, действующее/проживающее в одном государстве, но постоянно зарегистрированное/проживающее в другом

Нетто — а) чистый вес товара (без упаковки); б) чистый доход за минусом расходов

Номинальная стоимость — стоимость, которая печатается на лицевой стороне ценной бумаги. Может быть выше или ниже рыночной стоимости

Норма естественной убыли — величина допустимых естественных потерь товаров от усушки, утруски при перевозке, перевалке, хранении

Ноухау — накопленные предприятием научные и технические знания, производственный опыт

Нулевая декларация — разновидность налоговой декларации, форма нулевой налоговой отчетности

Нулевая отчетность — совокупность документов бухгалтерской, налоговой и статистической отчетности, которые предоставляются налогоплательщиками в контролирующие органы Российской Федерации в соответствии с требованиями законодательством в случае отсутствия финансово-хозяйственной деятельности в отчетном периоде

Нулевой баланс — утвержденная форма бухгалтерского учёта компаний, не имеющих финансово-хозяйственной деятельности (итоговая прибыль равна нулю или отрицательна)

О
Облигация — долговая ценная бумага. Ее владелец получает доход в форме определенного процента

Оборот по счету — сумма по операциям за отчетный период

Оборотная ведомость по аналитическим счетам — ведомость для проверки правильности записей по аналитическим счетам

Оборотная ведомость по синтетическим счетам — способ отражения и проверки полноты записей на синтетических счетах

Оборотные активы — материальные оборотные средства, средства в текущих расчетах, краткосрочные финансовые вложения, денежные средства, расположенные в балансе в порядке возрастания ликвидности

Обратные записи (проводки) — способ исправления неправильной корреспонденции счетов

Общая (основная, традиционная, классическая) система налогообложения — режим налогообложения, при котором предприниматель должен платить все общие налоги и вести полный учет. Для общей системы налогообложения нет отдельной главы в НК РФ

Обязательства — задолженность организации, возникшая в результате прошлых хозяйственных событий и сделок, выполнение которых влечет за собой будущую передачу активов

Операционные счета — счета для получения информации о затратах на производство продукции с целью подсчета ее себестоимости

Оправдательный документ — документ, подтверждающий факт осуществления хозяйственной операции

Основные материалы — часть материально-производственных запасов, образующих вещественную (материальную) основу готового продукта, например, металл, ткань, мука и т. п

Основные средства — часть средств труда, используемых организацией при производстве продукции (работ, услуг), для управленческих нужд в течение периода, превышающего 12 месяцев

Основные счета — счета для учета имущества организации, его источников и расчетов

Остаточная стоимость нематериальных активов — первоначальная стоимость НМА за вычетом суммы начисленной амортизации. Определяется как разница между оборотом по дебету счета 04 «Нематериальные активы» и оборотом по кредиту счета 05 «Амортизация нематериальных активов»

Остаточная стоимость основных средств — первоначальная (восстановительная) стоимость за вычетом суммы начисленной амортизации. Определяется в виде разницы между дебетовым оборотом по счету 01 «Основные средства» и кредитовым оборотом по счету 02 «Амортизация основных средств»

Отклонение в стоимости материальных ценностей — разница между фактической и учетной (нормативной, плановой) стоимостью заготовления материально-производственных запасов

Отчетная дата — дата, по состоянию на которую организация должна составлять бухгалтерскую отчетность

Отчетный период — промежуток времени, определяемый нормативными документами, который включает происходившие на его протяжении или относящиеся к нему факты хозяйственной деятельности, отражаемые в бухгалтерском учёте и бухгалтерской отчётности

Оценка — способ выражения хозяйственных явлений в денежном измерении

П
Пассив баланса — часть бухгалтерского баланса, в которой представлены источники образования и назначения активов

Пассивные счета — счета, предназначенные для учета источников образования имущества (счета «Уставный капитал», «Добавочный капитал» и др.)

Патентная система налогообложения — специальный режим налогообложения, применяемая только для ИП, ведущих определенные виды деятельности. Предполагает получение патента, освобождающего от уплаты НДФЛ, налога на имущество и НДС

Первичный документ — письменное доказательство совершения хозяйственной операции или разрешение на ее осуществление

Первоначальная стоимость — оценка, по которой к бухгалтерскому учету принимаются объекты основных средств, нематериальных и других активов

Переоценка основных средств — изменение оценки основных средств, позволяющее первоначальную стоимость объемов привести к сопоставимым ценам, отражающим современные условия воспроизводства

Персонифицированный учет — организация и ведение учета сведений о каждом застрахованном лице для целей государственного пенсионного страхования

План счетов бухгалтерского учета — систематизированный перечень счетов бухгалтерского учета (синтетических и субсчетов)

Платежное поручение — письменное распоряжение плательщика обслуживающему его банку осуществить платеж

Платежное требование — документ, представляемый в банк получателя с требованием к плательщику об уплате указанной суммы

Подотчетные лица — работники организации, получившие деньги под отчет на командировочные расходы и хозяйственные нужды

Положение (стандарты) по бухгалтерскому учету — нормативный документ, обобщающий принципы и правила ведения бухгалтерского учета отдельных его объектов

Полуфабрикаты — предметы труда, прошедшие обработку в одном или нескольких цехах предприятия, но нуждающиеся в дальнейшей доработке (на предприятии или за его пределами)

Пользователи бухгалтерской информации — администрация организации, сторонние пользователи с прямым и непрямым финансовым интересом

Поставщик — юридическое (физическое) лицо, снабжающее организации материальными ресурсами, необходимыми для производства продукции, работ и услуг

Пошлина — денежный сбор, взимаемый рядом учреждений за выполнение их функций: судом, арбитражем, нотариатом, таможней

Прибыль — сумма превышения доходов над расходами

Принципы бухгалтерского учета — универсальные положения, используемые при решении практических задач

Проверка документов по существу — определение законности совершения операции

Проводка бухгалтерская (запись) — обозначение корреспонденции счетов с указанием суммы по операции

Простая бухгалтерская проводка (запись) — проводка, в которой корреспондируют только два счета

Прямые затраты — затраты, непосредственно отнесенные на себестоимость конкретных видов продукции

Р
Раздел бухгалтерского баланса — группа экономических однородных статей актива и пассива баланса

Разделительный баланс — документ, по которому при разделении юридического лица его права и обязанности переходят к вновь возникшим юридическим лицам

Разницы инвентаризационные — разницы между фактическими и учетными данными, выявленные в ходе проведения инвентаризации

Распорядительный документ — документ, содержащий распоряжение на совершение хозяйственной операции

Расходы будущих периодов — затраты, произведенные в отчетном периоде и подлежащие списанию в течение периода, к которому они относятся в порядке, устанавливаемом самой организацией

Расчетно-платежная ведомость — регистр, применяемый для начисления и оплаты труда работников

Расчетный счет — счет, открываемый организациям в банках для хранения денежных средств и осуществления безналичных расчетов

Регистры систематического учета — документы, в которых группируются однородные по экономическому содержанию хозяйственные операции

Регистры учетные — документы, в которых осуществляются группировка и систематизация информации, отраженной в первичных документах

Регистры хронологические учета — документы, в которых отражаются хозяйственные операции в порядке их совершения

Резерв на оплату отпусков — источник средств для оплаты отпусков работников организации

Резервный капитал — часть собственного капитала, создаваемого за счет прибыли для покрытия потерь, выплаты дивидендов при недостаточности других источников

Резервный фонд — фонд, формируемый в расходной части бюджета на финансирование непредвиденных расходов

Резервы предстоящих расходов — часть капитала организации, созданного для выравнивания затрат по отчетным периодам (резерв на оплату отпусков работников и т. д.)

Резидент — это юридическое или физическое лицо, зарегистрированное в стране, на которое в полной мере распространяется национальное законодательство

Резидентство — один из критериев определения отношения юридического лица к налоговой юрисдикции государства, состоящий в том, что резидентом признается юридическое лицо, центр фактического руководства которого располагается на территории данного государства

Реквизит — показатель документа

Ремитент — держатель переводного векселя

Роялти — периодические отчисления продавцу (лицензиару) за право пользования предметом лицензионного соглашения: патентом, авторским правом, франшизой, природными ресурсами и др

Рыночная стоимость — денежное выражение цены (или иных эквивалентов), с которыми согласны продавец и покупатель, не подверженные никакому давлению и хорошо осведомленные о всех имеющих отношение к покупке фактах

С
Сальдировать — подсчитывать итоги, выводить остаток

Сальдо — остаток на счету

Сальдовая ведомость по счетам аналитического учета — ведомость остатков по аналитическим счетам

Самозанятый гражданин — физическое лицо, которое не имеет наемных работников и получило патент на занятие тем видом деятельности, в отношении которого может применяться патентная система

Себестоимость полная — затраты на производство и продажу продукции

Себестоимость продукции — затраты организации на производство продукции в размере стоимости используемых материальных, трудовых и иных ресурсов, а также стоимости потреблённых работ и услуг, выполненных сторонними организациями, в целях осуществления своей уставной деятельности

Себестоимость производственная — затраты организации на производство продукции

Сертификат — вид ценных бумаг

Сертификат налогового резидентства — это документ, подтверждающий, что физическое лицо или организация имеют статус налогового резидента РФ

Система налогообложения — установленный порядок сбора налогов

Собственный капитал — часть капитала организации, состоящая из уставного, добавочного и резервного капитала, нераспределенной прибыли

Средняя себестоимость — способ оценки материалов при отпуске в производство, исчислимый делением стоимости всех материалов на количество единиц данного вида ценностей

Ссуда — денежные средства (имущество), предоставляемые во временное пользование. Оформляется договором займа

Стандарт (нормы) — комплекс документально оформленных правил ведения бухгалтерского учета

Статья бухгалтерского баланса — элемент актива и пассива баланса, характеризующий отдельные виды имущества или источников его образования

Страховые взносы — обязательные платежи, которые осуществляются страхователями во внебюджетные фонды

Субаренда — сдача в аренду всего или части арендуемого имущества

Субсчет — способ группировки информации, содержащейся на аналитических счетах; занимает промежуточное положение между синтетическими и аналитическими счетами

Сырье — часть материально-производственных запасов организации, образующая материальную основу готового продукта (продукты сельского хозяйства и добывающей промышленности)

Т
Таможенная пошлина — обязательный платеж в федеральный бюджет, взимаемый таможенными органами в связи с перемещением товаров через таможенную границу

Текущие активы — часть экономических ресурсов, используемых в пределах установленного лимита времени (до одного года)

Товарная продукция — объем произведенной организацией продукции для продажи

Товарный знак (Товарная марка) — зарегистрированный специальный отличительный знак торгового предприятия, торговой фирмы

Товары — часть материально-производственных запасов, приобретенных или полученных от других юридических или физических лиц для продажи или перепродажи без доработки

Торговый сбор — обязательный фиксированный ежеквартальный платеж, который нужно перечислять за право ведения торговой деятельности на объектах осуществления торговли. Освобождаются от уплаты торгового сбора ИП на патентной системе и налогоплательщики, уплачивающие единый сельскохозяйственный налог

Требования — основные принципы бухгалтерского учета, означающие соблюдение принятых правил организации и ведения бухгалтерского учета

У
Убытки — потеря активов по разным причинам (нерациональное хозяйствование, стихийные бедствия и др.)

Управленческий учет — бухгалтерский учет внутри организации, необходимый для управления ее экономическими ресурсами

Упрощённая система налогообложения — специальный налоговый режим, направленный на снижение налоговой нагрузки на субъекты малого и среднего бизнеса, а также облегчение и упрощение ведения налогового учёта и бухгалтерского учёта. В зависимости от объекта налогообложения делиться на «Доходы» и «Доходы минус расходы»

УСНО «Доходы минус расходы» — упрощенная система налогообложения, при которой для расчёта налога берётся доход, уменьшенный на величину расхода, налоговая ставка составляет 15%

УСНО «Доходы» — упрощенная система налогообложения, при которой налог уплачивается с суммы доходов, налоговая ставка составляет 6%

Учетная политика — выбранная самой организацией совокупность методических способов ведения бухгалтерского учета

Ф
Факсимиле — штамп, обеспечивающий точное воспроизведение собственноручной росписи должностного лица и служащий для удостоверения его полномочий

Федеральная служба государственной статистики — федеральный орган исполнительной власти, осуществляющим функции по формированию официальной статистической информации о социальном, экономическом, демографическом и экологическом положении страны, а также функции по контролю и надзору в области государственной статистической деятельности на территории Российской Федерации

Финансовые вложения — инвестиции организаций в ценные бумаги, уставные капиталы других хозяйствующих субъектов и предоставленные займы

Финансовый год — законодательно установленный годовой срок, за который в соответствии с нормами налогового права составляется финансовая отчетность о результатах деятельности субъектов хозяйствования различных организационно-правовых форм

ФИФО — способ оценки материалов при отпуске в производство: первая партия к поступлению, первая партия в расход

Х
Хозяйственная операция — факт хозяйственной деятельности, отраженный в бухгалтерском учете

Хозяйствующий субъект — самостоятельная хозяйственная единица

Ц
ЦБ России — верхний уровень двухуровневой банковской системы в России, которая состоит из Центрального банка Российской Федерации и частных банков и кредитных организаций. Российский центральный банк контролирует деятельность кредитных организаций, выдаёт и отзывает у них лицензии на осуществление банковских операций, а уже кредитные компании работают с прочими юридическими и физическими лицами

Целевое финансирование — полученные из бюджета, от других организаций и лиц источники, предназначенные для осуществления мероприятий целевого назначения

Ч
Чистые активы — реальная стоимость имеющегося у общества имущества, ежегодно определяемая за вычетом его долгов

Ш
Шахматная оборотная ведомость — способ отражения и проверки правильности корреспонденции счетов

Э
Электронная отчётность — система представления налоговой и бухгалтерской отчётности в электронном виде по телекоммуникационным каналам связи

Электронная цифровая подпись — аналог собственноручной подписи, являющийся средством защиты информации, обеспечивающим возможность контроля целостности и подтверждения подлинности электронных документов

Электронные торги — урегулированная нормами права система общественных отношений между участниками электронного взаимодействия размещенной в сети Интернет информационной системы общего пользования, с использованием которой эти участники совершают между собой гражданско-правовые сделки по реализации товаров, работ или услуг

Электронный документооборот — единый механизм по работе с документами, представленными в электронном виде, с реализацией концепции «безбумажного делопроизводства»